*E*****************************************
*                                   *     *
* ********************************* * *** *
*                                 * * *   *
********************************* * * * ***
*                                 * * *   *
* ********************************* * *** *
*                                 * * *   *
********************************* * * * ***
*                                 * * *   *
* ********************************* * *** *
*                                 * * *   *
********************************* * * * ***
*                                 * * *   *
* ********************************* * *** *
*                                 * * *   *
********************************* * * * ***
*                                 * * *   *
* ********************************* * *** *
*                                 * * *   *
********************************* * * * ***
*                                 * * *   *
* ********************************* * *** *
*                                 * * *   *
********************************* * * * ***
*                                 *s* *   *
* *********************************** *** *
*                                     *   *
*************************************** ***
*                                       * *
* *************************************** *
*                                         *
***************************************** *
*                                         *
* *****************************************
*                                         *
***************************************** *
*                                         *
* *****************************************
*                                         *
***************************************** *
*                                         *
* *****************************************
*                                         *
***************************************** *
*                                         *
* *****************************************
*                                         *
***************************************** *
*                                         *
* *****************************************
*                                         *
***************************************** *
*                                         *
* *****************************************
*                                         *
*******************************************
