*****************************************
*     *                                 *
* *** * ******************************* *
*   * * *                               *
*** * * * *******************************
*   * * *                               *
* *** * ******************************* *
*   *s* *                               *
*** *** * *******************************
*   *   *                               *
* *** ********************************* *
*     *                                 *
******* *********************************
*       *                               *
* ******* ***************************** *
*         *                             *
*********** *****************************
*           *                           *
* *********** ************************* *
*             *                         *
*************** *************************
*               *                       *
* *************** ********************* *
*                 *                     *
******************* *********************
*                                       *
****E************************************
