*E***********************
*   *   *   *   *   *   *
* * * * * * * * * * * * *
* * * * * * * * * * * * *
* * * * * * * * * * * * *
* * * * * * * * * * * * *
* * * * * * * * * * * * *
* * * * * * * * * * * * *
* * * * * * * * * * * * *
* * * * * * * * * * * * *
* * * * * * * * * * * * *
* * * * * * * * * * * * *
* * * * * * * * * * * * *
* * * * * * * * * * * * *
* * * * * * * * * * * * *
* * * * * * * * * * * * *
* * * * * * * * * * * * *
* * * * * * * * * * * * *
* * * * * * * * * * * * *
* * * * * * * * * * * * *
* * * * * * * * * * * * *
* * * * * * * * * * * * *
* * * * * * * * * * * ***
* * * * * * * * * * *   *
* * * * * * * * * * *** *
* * * * * * * * * *   * *
* * * * * * * * * *** * *
* * * * * * * * *   * * *
* * * * * * * * *** * * *
* * * * * * * *   * * * *
* * * * * * * *** * * * *
* * * * * * * *s* * * * *
* * * * * * * * * * * * *
* * * * * * * * * * * * *
* * * * * * * * * * * * *
* *   *   *   * * * * * *
* ************* * * * * *
*               *   *   *
*************************
