*E*******
*   *   *
* *** * *
* *   * *
* * *** *
* * *s* *
* * * * *
*   *   *
*********
