*****************************************
*                                       *
*************************************** *
*                                       *
* ***************************************
*                                       *
*************************************** *
*                                       *
* ***************************************
*                                       *
*************************************** *
*                                       *
* ***************************************
*                                       *
*************************************** *
*                                       *
* ***************************************
*                                       *
*************************************** *
*                                       *
* ***************************************
*                                       *
*************************************** *
*                                       *
* ***************************************
*                                       *
*************************************** *
*                                       *
* ***************************************
*                                 *s    *
********************************* ***** *
*                                     * *
* ************************************* *
*                                     * *
************************************* * *
*                                     * *
* ************************************* *
*                                     * *
************************************* * *
*                                     * *
* ************************************* *
*                                     * *
************************************* * *
*                                     * *
* ************************************* *
*                                     * *
************************************* * *
*                                     * *
* ************************************* *
*                                       *
***********E*****************************
