*************************************
* *   *   *   *   *   *   *   *   * *
* * * * * * * * * * * * * * * * * * *
* * * * * * * * * * * * * * * * * * *
* * * * * * * * * * * * * * * * * * *
* *s* * * * * * * * * * * * * * * * *
* *** * * * * * * * * * * * * * * * *
*   * * * * * * * * * * * * * * * * *
* * * * * * * * * * * * * * * * * * *
* * * * * * * * * * * * * * * * * * *
* * * * * * * * * * * * * * * * * * *
* * * * * * * * * * * * * * * * * * *
* * * * * * * * * * * * * * * * * * *
* * * * * * * * * * * * * * * * * * *
* * * * * * * * * * * * * * * * * * *
* *     *   *   *   *   *   *   *   *
*****E*******************************
